@@@@@@@@@@@@@@@@@@@@@@@@@@@@@
@ *                         @
@                           @
@                           @
@               #           @
@                           @
@                           @
@@@@@@@@@@@@@@@@@@@@@@@@@@@@@